dims: 49 25
rooms: 32
start: 1 1
goal: 47 23

xxxxxxxxxxxxxxxxxxxxxxxxxxxxxxxxxxxxxxxxxxxxxxxxx
x^^^^^x!!!!!""""""x/////x.....x,,,,,x`````x00000x
x^^^^^x!!!!!x"""""x/////x.....x,,,,,x`````x00000x
x^^^^^x!!!!!x"""""x/////x.....x,,,,,x`````x00000x
x^^^^^!!!!!!x"""""x//////.....x,,,,,x`````x00000x
x^^^^^x!!!!!x""""""/////x......,,,,,```````00000x
x^xxxxx!!!!!xxxxxxx/////xxxxxxxxxxxxx`````xxxxxxx
x-----xxxxxxx(((((xxxxxxx[[[[[x]]]]]xxxxxxx|||||x
x-----x+++++x(((((x)))))x[[[[[x]]]]]x\\\\\||||||x
x-----x++++++(((((()))))x[[[[[x]]]]]x\\\\\x|||||x
x-----x+++++x(((((x)))))x[[[[[]]]]]]x\\\\\x|||||x
x------+++++x(((((x)))))[[[[[[x]]]]]\\\\\\x|||||x
xxxx-xxxxxxxxxxxxxxxxxxxxxxxxxxxxxxxxxxxxxxxxxxxx
x88888x11111x44444x55555x:::::x;;;;;x??????'''''x
x88888111111x44444x55555x:::::;;;;;;x?????x'''''x
x88888x11111x44444x55555x:::::x;;;;;x?????x'''''x
x88888x11111444444x555555:::::x;;;;;x?????x'''''x
x88888x11111x44444455555x:::::x;;;;;??????x'''''x
x8xxxxx11111xxxxxxx55555xxxxxxxxxxxxx?????xxxxxxx
x22222xxxxxxx77777xxxxxxx99999x<<<<<xxxxxxx>>>>>x
x22222x33333x77777x66666x99999x<<<<<x=====>>>>>>x
x22222x33333377777x66666x99999x<<<<<<=====x>>>>>x
x22222x33333x77777x66666x999999<<<<<x=====x>>>>>x
x22222233333x77777666666999999x<<<<<x=====x>>>>>x
xxxxxxxxxxxxxxxxxxxxxxxxxxxxxxxxxxxxxxxxxxxxxxxxx

