dims: 25 13
rooms: 8
start: 1 1
goal: 23 11

xxxxxxxxxxxxxxxxxxxxxxxxx
x55555111111x44444400000x
x55555x11111x44444x00000x
x55555x11111x44444x00000x
x55555x11111444444x00000x
x55555x11111x44444x00000x
x5xxxxx11111xxxxxxx00000x
x22222xxxxxxx77777xxxxxxx
x22222x33333777777x66666x
x22222x33333x77777x66666x
x22222x33333x77777x66666x
x22222233333x77777666666x
xxxxxxxxxxxxxxxxxxxxxxxxx

