dims: 25 13
rooms: 8
start: 1 1
goal: 23 11

xxxxxxxxxxxxxxxxxxxxxxxxx
x55555x11111144444x00000x
x55555x11111x44444x00000x
x55555x11111x44444x00000x
x55555111111x44444x00000x
x55555x11111x44444400000x
x5xxxxx11111xxxxx4x00000x
x22222xxxx3xx77777xx6xxxx
x22222x33333777777x66666x
x22222x33333x77777x66666x
x22222x33333x77777x66666x
x22222233333x77777666666x
xxxxxxxxxxxxxxxxxxxxxxxxx

