dims: 17 17
rooms: 4
start: 1 1
goal: 15 15

xxxxxxxxxxxxxxxxx
x0000000x1111111x
x0000000x1111111x
x0000000x1111111x
x0000000x1111111x
x000000001111111x
x0000000x1111111x
x0000000x1111111x
xx2xxxxxx1111111x
x2222222xxxx1xxxx
x2222222x3333333x
x2222222x3333333x
x2222222x3333333x
x222222233333333x
x2222222x3333333x
x2222222x3333333x
xxxxxxxxxxxxxxxxx

