dims: 49 25
rooms: 32
start: 1 1
goal: 47 23

xxxxxxxxxxxxxxxxxxxxxxxxxxxxxxxxxxxxxxxxxxxxxxxxx
x^^^^^x!!!!!!"""""x/////x.....x,,,,,x``````00000x
x^^^^^x!!!!!x"""""x/////x.....,,,,,,x`````x00000x
x^^^^^x!!!!!x"""""x/////x.....x,,,,,x`````x00000x
x^^^^^!!!!!!x"""""x//////.....x,,,,,x`````x00000x
x^^^^^x!!!!!x""""""/////x.....x,,,,,``````x00000x
x^xxxxx!!!!!xxxx(xx/////xxxx.xxxxx]xx`````xxxx0xx
x-----xxx!xxx(((((xxxxx/x[[[[[x]]]]]xxxxx\x|||||x
x-----x++++++(((((x)))))x[[[[[x]]]]]x\\\\\>|||||x
x-----x+++++x(((((x)))))x[[[[[x]]]]]=\\\\\x|||||x
x-----x+++++x(((((x)))))x[[[[[<]]]]]x\\\\\x|||||x
x------+++++x((((())))))[[[[[[x]]]]]x\\\\\x|||||x
xxxx-xxxx+xxxxxx(xxxx)xxxx[xxxx]xxxxx\xxxxxxxxx|x
x88888x11111144444x55555x:::::x;;;;;x??????'''''x
x88888x11111x44444x55555x:::::;;;;;;x?????x'''''x
x88888x11111x44444x55555x:::::x;;;;;x?????x'''''x
x88888111111x44444x555555:::::x;;;;;x?????x'''''x
x88888x11111x44444455555x:::::x;;;;;??????x'''''x
x8xxxxx11111xxxx7xx55555xxxx:xxxxx;xx?????xxxx'xx
x22222xxx1xxx77777xxxxx5x99999x<<<<<xxxxx=x>>>>>x
x22222x33333377777x66666x99999x<<<<<x=====>>>>>>x
x22222x33333x77777x66666x99999x<<<<<======x>>>>>x
x22222x33333x77777x66666x99999<<<<<<x=====x>>>>>x
x22222233333x77777666666999999x<<<<<x=====x>>>>>x
xxxxxxxxxxxxxxxxxxxxxxxxxxxxxxxxxxxxxxxxxxxxxxxxx

