dims: 25 13
rooms: 8
start: 1 1
goal: 23 11

xxxxxxxxxxxxxxxxxxxxxxxxx
x00000x11111144444x55555x
x00000x11111x44444x55555x
x00000x11111x44444x55555x
x00000111111x44444x55555x
x00000x11111x44444455555x
x0xxxxx11111xxxxx4x55555x
x22222xxxx3xx77777xx5xxxx
x22222x33333777777x66666x
x22222x33333x77777x66666x
x22222x33333x77777x66666x
x22222233333x77777666666x
xxxxxxxxxxxxxxxxxxxxxxxxx

