dims: 31 13
rooms: 10
start: 1 1
goal: 29 11

xxxxxxxxxxxxxxxxxxxxxxxxxxxxxxx
x00000x11111144444x55555588888x
x00000x11111x44444x55555x88888x
x00000x11111x44444x55555x88888x
x00000111111x44444x55555x88888x
x00000x11111x44444455555x88888x
x0xxxxx11111xxxx7xx55555xxxx8xx
x22222xxx1xxx77777xxxxx5x99999x
x22222x33333377777x66666x99999x
x22222x33333x77777x66666x99999x
x22222x33333x77777x66666x99999x
x22222233333x77777666666999999x
xxxxxxxxxxxxxxxxxxxxxxxxxxxxxxx

