dims: 25 13
rooms: 8
start: 1 1
goal: 23 11

xxxxxxxxxxxxxxxxxxxxxxxxx
x00000x11111x44444x55555x
x00000x11111x44444x55555x
x00000011111444444455555x
x00000111111144444555555x
x00000x11111x44444x55555x
xx20xxx11111xx74xxx55555x
x22222xxx13xx77777xx56xxx
x22222x33333x77777x66666x
x22222233333377777666666x
x22222333333777777766666x
x22222x33333x77777x66666x
xxxxxxxxxxxxxxxxxxxxxxxxx

