dims: 31 13
rooms: 10
start: 1 1
goal: 29 11

xxxxxxxxxxxxxxxxxxxxxxxxxxxxxxx
x88888x11111144444x55555x00000x
x88888x11111x44444x55555x00000x
x88888x11111x44444x55555x00000x
x88888x11111x44444x55555500000x
x88888x11111x44444455555x00000x
x8xxxxx11111xxxxxxx55555xxxxxxx
x22222xxx1xxx77777xxxxxxx99999x
x22222x33333377777x66666x99999x
x22222x33333x77777x66666x99999x
x22222x33333x77777x66666x99999x
x22222233333x77777666666999999x
xxxxxxxxxxxxxxxxxxxxxxxxxxxxxxx

