dims: 49 13
rooms: 16
start: 1 1
goal: 47 11

xxxxxxxxxxxxxxxxxxxxxxxxxxxxxxxxxxxxxxxxxxxxxxxxx
x88888x11111144444x555555:::::x;;;;;x??????00000x
x88888x11111x44444x55555x:::::;;;;;;x?????x00000x
x88888x11111x44444x55555x:::::x;;;;;x?????x00000x
x88888111111x44444x55555x:::::x;;;;;x?????x00000x
x88888x11111x44444455555x:::::x;;;;;;?????x00000x
x8xxxxx11111xxxxxxx55555xxxxxxxxxxxxx?????xxxxxxx
x22222xxxxxxx77777xxxxxxx999999<<<<<xxxxxxx>>>>>x
x22222x33333377777x66666x99999x<<<<<x=====>>>>>>x
x22222x33333x77777x66666x99999x<<<<<======x>>>>>x
x22222x33333x77777x66666x99999x<<<<<x=====x>>>>>x
x22222233333x77777666666999999x<<<<<x=====x>>>>>x
xxxxxxxxxxxxxxxxxxxxxxxxxxxxxxxxxxxxxxxxxxxxxxxxx

