dims: 17 17
rooms: 4
start: 1 1
goal: 15 15

xxxxxxxxxxxxxxxxx
x1111111x0000000x
x1111111x0000000x
x1111111x0000000x
x1111111x0000000x
x111111110000000x
x1111111x0000000x
x1111111x0000000x
xx2xxxxxx0000000x
x2222222xxxx3xxxx
x2222222x3333333x
x2222222x3333333x
x2222222x3333333x
x222222233333333x
x2222222x3333333x
x2222222x3333333x
xxxxxxxxxxxxxxxxx

