dims: 17 17
rooms: 4
start: 1 1
goal: 15 15

xxxxxxxxxxxxxxxxx
x1111111x0000000x
x1111111x0000000x
x1111111x0000000x
x1111111x0000000x
x111111110000000x
x1111111x0000000x
x1111111x0000000x
xx1xxxxxx0000000x
x1111111xxxx3xxxx
x1111111x3333333x
x1111111x3333333x
x1111111x3333333x
x111111133333333x
x1111111x3333333x
x1111111x3333333x
xxxxxxxxxxxxxxxxx

